#######################
    ###    G    ###    
##########   ##########
     #  #G G G#  #     
#####.# ####### #.#####
    #.#         #.#    
#####.#  #####  #.#####
#..........#..........#
#.###.####.#.####.###.#
#...#.f....P......#...#
